9 7
6 1
XXXXXXXXX
X    X  X
X    X  X
X    X  X
XXXXXX  X
X       X
X XXXXXXX