10 6
1 9
XXXXXXXXXX
X XXXXXX  
X XXXXXX X
X XXXXXX X
X        X
XXXXXXXXXX